E E E E E E E B E E E E D D D
E E E E E E E E E E E E D D D
E E E E E E E G E E E E D D D
B B B B E E E E E E E E E E E
E E E E E E E B E E E E E E E
E E E E E E E B B B E E E E B
E E E E E E E E E B E E E E B
E E E E E E E E E B E E E E E
E E E B E E E E E E E E E E E
B B B B E E E E E E E E E E E
E E E E E E E E E E E E E E E
E E E E E E E E E E E E E E E
E E E E E E E E E E E E E E B
E E E E E E E E E E E E E E B
E E E E B B B B B B E E E E B
E E E E B E E E E E E E E B B
E E E E E E E E E E E E E E E
C C C E E E E E E E E E E E E
C C C E E E E E E E E G E E E
C C C E E E E E E E E E E E E
